Country,Week,Age_group,Alpha,Beta,Delta,Omicron,Other_variants,Total
GRC,202009,60 – 70,0,0,0,0,1,1
GRC,202010,40 – 50,0,0,0,0,1,1
GRC,202011,50 – 60,0,0,0,0,1,1
GRC,202011,60 – 70,0,0,0,0,1,1
GRC,202013,30 – 40,0,0,0,0,1,1
GRC,202013,40 – 50,0,0,0,0,2,2
GRC,202014,40 – 50,0,0,0,0,2,2
GRC,202014,50 – 60,0,0,0,0,1,1
GRC,202014,60 – 70,0,0,0,0,2,2
GRC,202014,70 – 80,0,0,0,0,1,1
GRC,202014,>= 80,0,0,0,0,1,1
GRC,202015,20 – 30,0,0,0,0,1,1
GRC,202015,50 – 60,0,0,0,0,1,1
GRC,202015,70 – 80,0,0,0,0,1,1
GRC,202016,40 – 50,0,0,0,0,2,2
GRC,202017,30 – 40,0,0,0,0,1,1
GRC,202017,40 – 50,0,0,0,0,1,1
GRC,202017,50 – 60,0,0,0,0,1,1
GRC,202017,70 – 80,0,0,0,0,2,2
GRC,202018,30 – 40,0,0,0,0,1,1
GRC,202019,60 – 70,0,0,0,0,2,2
GRC,202020,50 – 60,0,0,0,0,1,1
GRC,202020,70 – 80,0,0,0,0,1,1
GRC,202020,>= 80,0,0,0,0,2,2
GRC,202053,20 – 30,3,0,0,0,3,6
GRC,202103,30 – 40,0,0,0,0,1,1
GRC,202110,30 – 40,1,0,0,0,0,1
GRC,202110,50 – 60,1,0,0,0,0,1
GRC,202110,70 – 80,0,0,0,0,1,1
GRC,202110,>= 80,2,0,0,0,0,2
GRC,202111,10 – 20,8,0,0,0,0,8
GRC,202111,20 – 30,15,0,0,0,2,17
GRC,202111,30 – 40,18,0,0,0,0,18
GRC,202111,40 – 50,17,0,0,0,1,18
GRC,202111,50 – 60,14,0,0,0,0,14
GRC,202111,60 – 70,11,0,0,0,1,12
GRC,202111,70 – 80,5,0,0,0,0,5
GRC,202111,>= 80,3,0,0,0,0,3
GRC,202112,10 – 20,0,0,0,0,1,1
GRC,202112,20 – 30,1,0,0,0,1,2
GRC,202112,30 – 40,3,0,0,0,1,4
GRC,202112,40 – 50,4,0,0,0,0,4
GRC,202112,50 – 60,2,0,0,0,0,2
GRC,202112,60 – 70,1,0,0,0,1,2
GRC,202112,70 – 80,1,0,0,0,0,1
GRC,202113,1 – 5,1,0,0,0,0,1
GRC,202113,10 – 20,6,0,0,0,0,6
GRC,202113,20 – 30,5,0,0,0,3,8
GRC,202113,30 – 40,5,0,0,0,0,5
GRC,202113,40 – 50,4,0,0,0,0,4
GRC,202113,50 – 60,4,0,0,0,0,4
GRC,202113,60 – 70,3,0,0,0,2,5
GRC,202113,70 – 80,3,0,0,0,0,3
GRC,202113,>= 80,0,0,0,0,2,2
GRC,202114,10 – 20,3,0,0,0,1,4
GRC,202114,30 – 40,1,0,0,0,1,2
GRC,202114,40 – 50,4,0,0,0,0,4
GRC,202114,50 – 60,6,0,0,0,1,7
GRC,202114,60 – 70,2,0,0,0,0,2
GRC,202114,70 – 80,1,0,0,0,0,1
GRC,202115,40 – 50,1,0,0,0,0,1
GRC,202115,50 – 60,1,0,0,0,0,1
GRC,202116,10 – 20,1,0,0,0,0,1
GRC,202116,40 – 50,1,0,0,0,0,1
GRC,202117,20 – 30,1,0,0,0,0,1
GRC,202117,60 – 70,1,0,0,0,0,1
GRC,202118,10 – 20,14,0,0,0,0,14
GRC,202118,20 – 30,19,0,0,0,0,19
GRC,202118,30 – 40,8,0,0,0,0,8
GRC,202118,40 – 50,20,0,0,0,1,21
GRC,202118,5 – 10,1,0,0,0,0,1
GRC,202118,50 – 60,11,0,0,0,1,12
GRC,202118,60 – 70,10,0,0,0,0,10
GRC,202118,70 – 80,1,0,0,0,0,1
GRC,202118,>= 80,2,0,0,0,0,2
GRC,202119,10 – 20,23,0,0,0,0,23
GRC,202119,20 – 30,19,0,0,0,0,19
GRC,202119,30 – 40,15,0,0,0,0,15
GRC,202119,40 – 50,17,0,0,0,0,17
GRC,202119,5 – 10,6,0,0,0,0,6
GRC,202119,50 – 60,12,0,0,0,1,13
GRC,202119,60 – 70,13,0,0,0,0,13
GRC,202119,70 – 80,1,0,0,0,0,1
GRC,202120,10 – 20,28,0,0,0,13,41
GRC,202120,20 – 30,13,0,0,0,4,17
GRC,202120,30 – 40,10,0,0,0,4,14
GRC,202120,40 – 50,16,0,0,0,3,19
GRC,202120,5 – 10,2,0,0,0,1,3
GRC,202120,50 – 60,14,0,0,0,10,24
GRC,202120,60 – 70,4,1,0,0,4,9
GRC,202120,70 – 80,0,0,0,0,1,1
GRC,202120,>= 80,1,0,0,0,0,1
GRC,202121,10 – 20,4,0,0,0,9,13
GRC,202121,20 – 30,1,0,0,0,5,6
GRC,202121,30 – 40,5,0,0,0,4,9
GRC,202121,40 – 50,5,0,0,0,9,14
GRC,202121,5 – 10,0,0,0,0,1,1
GRC,202121,50 – 60,2,0,0,0,4,6
GRC,202121,60 – 70,2,0,0,0,0,2
GRC,202122,1 – 5,0,0,0,0,3,3
GRC,202122,10 – 20,0,0,0,0,10,10
GRC,202122,20 – 30,0,0,0,0,7,7
GRC,202122,30 – 40,0,0,0,0,11,11
GRC,202122,40 – 50,0,0,0,0,11,11
GRC,202122,5 – 10,0,0,0,0,6,6
GRC,202122,50 – 60,0,0,0,0,10,10
GRC,202122,60 – 70,0,0,0,0,3,3
GRC,202122,70 – 80,0,0,0,0,1,1
GRC,202122,>= 80,0,0,0,0,1,1
GRC,202123,1 – 5,0,0,0,0,1,1
GRC,202123,10 – 20,2,0,0,0,5,7
GRC,202123,20 – 30,6,0,0,0,13,19
GRC,202123,30 – 40,5,0,0,0,8,13
GRC,202123,40 – 50,5,0,0,0,15,20
GRC,202123,5 – 10,2,0,0,0,0,2
GRC,202123,50 – 60,7,0,1,0,8,16
GRC,202123,60 – 70,4,0,0,0,5,9
GRC,202123,70 – 80,3,2,0,0,1,6
GRC,202123,>= 80,1,0,0,0,0,1
GRC,202124,10 – 20,5,0,3,0,8,16
GRC,202124,20 – 30,13,0,0,0,3,16
GRC,202124,30 – 40,7,0,1,0,8,16
GRC,202124,40 – 50,5,0,0,0,7,12
GRC,202124,5 – 10,1,0,1,0,0,2
GRC,202124,50 – 60,3,0,1,0,7,11
GRC,202124,60 – 70,3,0,0,0,2,5
GRC,202124,70 – 80,0,0,0,0,4,4
GRC,202125,20 – 30,1,0,0,0,0,1
GRC,202125,50 – 60,1,0,0,0,1,2
GRC,202126,1 – 5,1,0,0,0,0,1
GRC,202126,10 – 20,0,0,1,0,0,1
GRC,202126,20 – 30,1,1,2,0,1,5
GRC,202126,30 – 40,0,1,2,0,0,3
GRC,202126,40 – 50,1,0,2,0,1,4
GRC,202126,60 – 70,0,0,1,0,0,1
GRC,202126,>= 80,0,0,0,0,1,1
GRC,202127,1 – 5,0,0,1,0,0,1
GRC,202127,10 – 20,8,2,13,0,0,23
GRC,202127,20 – 30,4,1,12,0,3,20
GRC,202127,30 – 40,2,0,8,0,0,10
GRC,202127,40 – 50,0,1,6,0,0,7
GRC,202127,50 – 60,0,0,6,0,0,6
GRC,202127,60 – 70,2,0,0,0,0,2
GRC,202127,70 – 80,1,0,0,0,0,1
GRC,202127,>= 80,1,1,0,0,0,2
GRC,202128,10 – 20,1,0,6,0,0,7
GRC,202128,20 – 30,1,1,5,0,0,7
GRC,202128,30 – 40,0,0,4,0,0,4
GRC,202128,40 – 50,0,0,2,0,0,2
GRC,202128,50 – 60,0,0,3,0,0,3
GRC,202128,60 – 70,0,1,1,0,0,2
GRC,202128,70 – 80,0,0,2,0,0,2
GRC,202128,>= 80,0,0,1,0,0,1
GRC,202129,10 – 20,2,0,8,0,0,10
GRC,202129,20 – 30,4,0,12,0,0,16
GRC,202129,30 – 40,0,0,6,0,4,10
GRC,202129,40 – 50,0,0,10,0,0,10
GRC,202129,5 – 10,0,0,4,0,0,4
GRC,202129,50 – 60,2,0,0,0,0,2
GRC,202130,10 – 20,6,0,74,0,0,80
GRC,202130,20 – 30,6,0,64,0,2,72
GRC,202130,30 – 40,2,0,32,0,0,34
GRC,202130,40 – 50,0,2,18,0,0,20
GRC,202130,5 – 10,0,0,2,0,0,2
GRC,202130,50 – 60,2,0,12,0,2,16
GRC,202130,60 – 70,4,0,14,0,0,18
GRC,202130,>= 80,0,0,4,0,0,4
GRC,202131,10 – 20,0,0,0,0,1,1
GRC,202131,40 – 50,0,0,1,0,0,1
GRC,202131,70 – 80,0,0,1,0,0,1
GRC,202135,20 – 30,0,0,1,0,0,1
GRC,202135,>= 80,0,0,1,0,0,1
GRC,202136,10 – 20,0,0,9,0,0,9
GRC,202136,20 – 30,0,0,6,0,0,6
GRC,202136,30 – 40,0,0,13,0,0,13
GRC,202136,40 – 50,0,0,8,0,0,8
GRC,202136,5 – 10,0,0,2,0,0,2
GRC,202136,50 – 60,0,0,3,0,0,3
GRC,202136,60 – 70,0,0,2,0,0,2
GRC,202136,70 – 80,0,0,1,0,0,1
GRC,202136,>= 80,0,0,1,0,0,1
GRC,202143,20 – 30,0,0,3,0,0,3
GRC,202144,30 – 40,0,0,1,0,0,1
