Country,Week,Age_group,Alpha,Beta,Delta,Omicron,Other_variants,Total
EST,202050,70 – 80,0,0,0,0,1,1
EST,202051,40 – 50,0,0,0,0,1,1
EST,202052,>= 80,0,0,0,0,1,1
EST,202053,50 – 60,0,0,0,0,1,1
EST,202101,20 – 30,0,0,0,0,2,2
EST,202101,30 – 40,0,0,0,0,1,1
EST,202102,50 – 60,0,0,0,0,1,1
EST,202103,20 – 30,0,0,0,0,1,1
EST,202103,40 – 50,0,0,0,0,2,2
EST,202103,50 – 60,0,0,0,0,1,1
EST,202103,60 – 70,1,0,0,0,0,1
EST,202103,70 – 80,0,0,0,0,1,1
EST,202103,>= 80,0,0,0,0,2,2
EST,202104,20 – 30,0,0,0,0,2,2
EST,202104,30 – 40,0,0,0,0,2,2
EST,202104,40 – 50,0,0,0,0,2,2
EST,202104,50 – 60,0,0,0,0,9,9
EST,202104,60 – 70,0,0,0,0,8,8
EST,202104,70 – 80,0,0,0,0,1,1
EST,202104,>= 80,0,0,0,0,7,7
EST,202105,30 – 40,0,0,0,0,1,1
EST,202105,40 – 50,0,0,0,0,2,2
EST,202105,50 – 60,0,0,0,0,2,2
EST,202105,60 – 70,0,0,0,0,2,2
EST,202105,70 – 80,0,0,0,0,2,2
EST,202105,>= 80,1,0,0,0,4,5
EST,202106,10 – 20,1,0,0,0,6,7
EST,202106,20 – 30,0,0,0,0,14,14
EST,202106,30 – 40,4,0,0,0,15,19
EST,202106,40 – 50,5,0,0,0,14,19
EST,202106,5 – 10,1,0,0,0,2,3
EST,202106,50 – 60,2,0,0,0,12,14
EST,202106,60 – 70,1,0,0,0,8,9
EST,202106,70 – 80,0,0,0,0,8,8
EST,202106,>= 80,0,0,0,0,15,15
EST,202107,1 – 5,0,0,0,0,1,1
EST,202107,10 – 20,18,0,0,0,33,51
EST,202107,20 – 30,15,0,0,0,46,61
EST,202107,30 – 40,19,0,0,0,54,73
EST,202107,40 – 50,17,2,0,0,56,75
EST,202107,5 – 10,4,0,0,0,6,10
EST,202107,50 – 60,18,0,0,0,44,62
EST,202107,60 – 70,15,0,0,0,39,54
EST,202107,70 – 80,3,0,0,0,19,22
EST,202107,>= 80,1,0,0,0,4,5
EST,202108,10 – 20,2,0,0,0,4,6
EST,202108,20 – 30,0,0,0,0,3,3
EST,202108,30 – 40,1,0,0,0,1,2
EST,202108,40 – 50,1,0,0,0,0,1
EST,202108,50 – 60,2,0,0,0,2,4
EST,202108,60 – 70,3,0,0,0,0,3
EST,202108,>= 80,1,0,0,0,3,4
EST,202109,1 – 5,1,0,0,0,0,1
EST,202109,10 – 20,9,0,0,0,5,14
EST,202109,20 – 30,5,0,0,0,6,11
EST,202109,30 – 40,12,0,0,0,5,17
EST,202109,40 – 50,8,1,0,0,3,12
EST,202109,5 – 10,1,0,0,0,0,1
EST,202109,50 – 60,7,0,0,0,4,11
EST,202109,60 – 70,7,0,0,0,8,15
EST,202109,70 – 80,3,0,0,0,1,4
EST,202109,< 1,1,0,0,0,0,1
EST,202109,>= 80,1,0,0,0,2,3
EST,202110,1 – 5,7,0,0,0,2,9
EST,202110,10 – 20,56,1,0,0,27,84
EST,202110,20 – 30,41,0,0,0,24,65
EST,202110,30 – 40,70,1,0,0,20,91
EST,202110,40 – 50,55,0,0,0,16,71
EST,202110,5 – 10,9,0,0,0,1,10
EST,202110,50 – 60,73,0,0,0,25,98
EST,202110,60 – 70,43,0,0,0,17,60
EST,202110,70 – 80,18,0,0,0,10,28
EST,202110,>= 80,6,0,0,0,3,9
EST,202111,1 – 5,5,0,0,0,0,5
EST,202111,10 – 20,36,0,0,0,5,41
EST,202111,20 – 30,58,0,0,0,6,64
EST,202111,30 – 40,75,2,0,0,27,104
EST,202111,40 – 50,71,0,0,0,20,91
EST,202111,5 – 10,10,0,0,0,2,12
EST,202111,50 – 60,45,0,0,0,24,69
EST,202111,60 – 70,42,0,0,0,16,58
EST,202111,70 – 80,15,0,0,0,6,21
EST,202111,>= 80,9,0,0,0,1,10
EST,202112,1 – 5,5,0,0,0,0,5
EST,202112,10 – 20,31,0,0,0,4,35
EST,202112,20 – 30,72,2,0,0,11,85
EST,202112,30 – 40,86,3,0,0,16,105
EST,202112,40 – 50,74,2,0,0,16,92
EST,202112,5 – 10,6,1,0,0,0,7
EST,202112,50 – 60,65,0,0,0,15,80
EST,202112,60 – 70,57,1,0,0,12,70
EST,202112,70 – 80,26,0,0,0,7,33
EST,202112,< 1,1,0,0,0,0,1
EST,202112,>= 80,13,0,0,0,4,17
EST,202113,1 – 5,4,1,0,0,2,7
EST,202113,10 – 20,50,0,0,0,5,55
EST,202113,20 – 30,76,1,0,0,9,86
EST,202113,30 – 40,99,3,0,0,9,111
EST,202113,40 – 50,101,5,0,0,5,111
EST,202113,5 – 10,12,1,0,0,1,14
EST,202113,50 – 60,84,3,0,0,7,94
EST,202113,60 – 70,68,0,0,0,5,73
EST,202113,70 – 80,29,0,0,0,3,32
EST,202113,< 1,1,0,0,0,0,1
EST,202113,>= 80,31,0,0,0,2,33
EST,202114,1 – 5,3,0,0,0,0,3
EST,202114,10 – 20,15,0,0,0,0,15
EST,202114,20 – 30,32,1,0,0,0,33
EST,202114,30 – 40,35,1,0,0,0,36
EST,202114,40 – 50,31,0,0,0,0,31
EST,202114,5 – 10,6,0,0,0,0,6
EST,202114,50 – 60,27,1,0,0,1,29
EST,202114,60 – 70,23,0,0,0,4,27
EST,202114,70 – 80,6,0,0,0,1,7
EST,202114,>= 80,9,0,0,0,0,9
EST,202115,1 – 5,3,0,0,0,0,3
EST,202115,10 – 20,13,0,0,0,0,13
EST,202115,20 – 30,25,0,0,0,1,26
EST,202115,30 – 40,36,0,0,0,2,38
EST,202115,40 – 50,24,0,0,0,0,24
EST,202115,5 – 10,7,0,0,0,0,7
EST,202115,50 – 60,21,0,0,0,0,21
EST,202115,60 – 70,26,0,0,0,0,26
EST,202115,70 – 80,8,0,0,0,0,8
EST,202115,>= 80,4,0,0,0,0,4
EST,202116,1 – 5,2,0,0,0,0,2
EST,202116,10 – 20,14,1,0,0,0,15
EST,202116,20 – 30,25,1,0,0,0,26
EST,202116,30 – 40,30,0,0,0,0,30
EST,202116,40 – 50,30,1,0,0,0,31
EST,202116,5 – 10,4,0,0,0,0,4
EST,202116,50 – 60,33,1,0,0,0,34
EST,202116,60 – 70,19,0,0,0,0,19
EST,202116,70 – 80,12,0,0,0,0,12
EST,202116,>= 80,5,0,0,0,0,5
EST,202117,1 – 5,3,0,0,0,0,3
EST,202117,10 – 20,22,0,0,0,0,22
EST,202117,20 – 30,21,0,0,0,0,21
EST,202117,30 – 40,29,0,0,0,1,30
EST,202117,40 – 50,31,0,0,0,1,32
EST,202117,5 – 10,2,0,0,0,0,2
EST,202117,50 – 60,25,0,0,0,0,25
EST,202117,60 – 70,17,0,0,0,0,17
EST,202117,70 – 80,8,0,0,0,0,8
EST,202117,>= 80,2,0,0,0,0,2
EST,202118,1 – 5,2,0,0,0,0,2
EST,202118,10 – 20,16,0,0,0,1,17
EST,202118,20 – 30,21,0,0,0,1,22
EST,202118,30 – 40,35,0,0,0,2,37
EST,202118,40 – 50,26,0,0,0,0,26
EST,202118,5 – 10,6,0,0,0,0,6
EST,202118,50 – 60,17,0,0,0,0,17
EST,202118,60 – 70,21,0,0,0,0,21
EST,202118,70 – 80,10,0,0,0,1,11
EST,202118,>= 80,5,0,0,0,0,5
EST,202119,1 – 5,2,0,0,0,1,3
EST,202119,10 – 20,18,0,0,0,0,18
EST,202119,20 – 30,26,0,0,0,0,26
EST,202119,30 – 40,34,0,0,0,1,35
EST,202119,40 – 50,29,0,0,0,0,29
EST,202119,5 – 10,9,0,0,0,0,9
EST,202119,50 – 60,19,0,0,0,0,19
EST,202119,60 – 70,18,0,0,0,0,18
EST,202119,70 – 80,5,0,0,0,0,5
EST,202119,< 1,1,0,0,0,0,1
EST,202119,>= 80,4,0,0,0,0,4
EST,202122,1 – 5,1,0,0,0,0,1
EST,202122,10 – 20,6,0,0,0,0,6
EST,202122,20 – 30,19,0,0,0,0,19
EST,202122,30 – 40,19,0,0,0,0,19
EST,202122,40 – 50,15,0,0,0,0,15
EST,202122,5 – 10,4,0,0,0,0,4
EST,202122,50 – 60,5,0,0,0,0,5
EST,202122,60 – 70,7,0,0,0,0,7
EST,202122,70 – 80,3,0,0,0,0,3
EST,202123,10 – 20,7,0,1,0,0,8
EST,202123,20 – 30,11,0,0,0,0,11
EST,202123,30 – 40,7,0,1,0,0,8
EST,202123,40 – 50,10,0,0,0,0,10
EST,202123,50 – 60,5,0,0,0,0,5
EST,202123,60 – 70,2,0,0,0,0,2
EST,202123,70 – 80,2,0,0,0,0,2
EST,202123,>= 80,1,0,0,0,0,1
EST,202124,10 – 20,3,0,0,0,0,3
EST,202124,20 – 30,8,0,0,0,0,8
EST,202124,30 – 40,12,0,0,0,0,12
EST,202124,40 – 50,9,0,0,0,0,9
EST,202124,50 – 60,7,0,0,0,0,7
EST,202124,60 – 70,8,0,0,0,0,8
EST,202124,70 – 80,1,0,0,0,0,1
EST,202124,>= 80,1,0,0,0,0,1
EST,202126,1 – 5,0,0,1,0,0,1
EST,202126,10 – 20,0,0,7,0,0,7
EST,202126,20 – 30,0,0,13,0,0,13
EST,202126,30 – 40,0,0,5,0,0,5
EST,202126,40 – 50,2,0,7,0,0,9
EST,202126,50 – 60,0,0,6,0,0,6
EST,202126,60 – 70,2,0,4,0,0,6
EST,202126,>= 80,0,0,2,0,0,2
EST,202127,1 – 5,1,0,3,0,0,4
EST,202127,10 – 20,1,0,9,0,0,10
EST,202127,20 – 30,7,0,16,0,0,23
EST,202127,30 – 40,1,0,20,0,0,21
EST,202127,40 – 50,1,0,10,0,0,11
EST,202127,5 – 10,0,0,6,0,0,6
EST,202127,50 – 60,0,0,11,0,0,11
EST,202127,60 – 70,0,0,3,0,0,3
EST,202127,70 – 80,0,0,1,0,0,1
EST,202127,>= 80,0,0,2,0,0,2
EST,202128,1 – 5,0,0,2,0,0,2
EST,202128,10 – 20,0,0,15,0,0,15
EST,202128,20 – 30,1,0,17,0,0,18
EST,202128,30 – 40,1,0,16,0,0,17
EST,202128,40 – 50,0,0,5,0,0,5
EST,202128,60 – 70,0,0,7,0,0,7
EST,202129,1 – 5,0,0,2,0,0,2
EST,202129,10 – 20,0,0,36,0,0,36
EST,202129,20 – 30,3,0,57,0,0,60
EST,202129,30 – 40,0,0,34,0,1,35
EST,202129,40 – 50,1,0,12,0,0,13
EST,202129,50 – 60,1,0,15,0,0,16
EST,202129,60 – 70,0,0,5,0,0,5
EST,202129,70 – 80,0,0,1,0,0,1
EST,202129,< 1,0,0,1,0,0,1
EST,202129,>= 80,0,0,2,0,0,2
EST,202130,1 – 5,0,0,7,0,0,7
EST,202130,10 – 20,0,0,30,0,0,30
EST,202130,20 – 30,1,0,58,0,0,59
EST,202130,30 – 40,1,0,37,0,0,38
EST,202130,40 – 50,0,0,20,0,0,20
EST,202130,5 – 10,0,0,2,0,0,2
EST,202130,50 – 60,0,0,10,0,0,10
EST,202130,60 – 70,0,0,8,0,0,8
EST,202130,70 – 80,0,0,1,0,0,1
EST,202130,< 1,0,0,1,0,0,1
EST,202130,>= 80,0,0,3,0,0,3
EST,202131,1 – 5,0,0,4,0,0,4
EST,202131,10 – 20,0,0,33,0,0,33
EST,202131,20 – 30,0,0,48,0,0,48
EST,202131,30 – 40,0,0,42,0,0,42
EST,202131,40 – 50,0,0,27,0,0,27
EST,202131,5 – 10,0,0,4,0,0,4
EST,202131,50 – 60,0,0,12,0,0,12
EST,202131,60 – 70,0,0,4,0,0,4
EST,202131,70 – 80,0,0,2,0,0,2
EST,202131,< 1,0,0,1,0,0,1
EST,202131,>= 80,0,0,1,0,0,1
EST,202132,1 – 5,0,0,2,0,0,2
EST,202132,10 – 20,0,0,22,0,0,22
EST,202132,20 – 30,0,0,26,0,0,26
EST,202132,30 – 40,0,0,36,0,0,36
EST,202132,40 – 50,0,0,29,0,0,29
EST,202132,5 – 10,0,0,8,0,0,8
EST,202132,50 – 60,0,0,31,0,0,31
EST,202132,60 – 70,0,0,12,0,0,12
EST,202132,70 – 80,0,0,10,0,0,10
EST,202132,< 1,0,0,2,0,0,2
EST,202132,>= 80,0,0,5,0,0,5
EST,202133,1 – 5,0,0,5,0,0,5
EST,202133,10 – 20,0,0,32,0,0,32
EST,202133,20 – 30,0,0,23,0,0,23
EST,202133,30 – 40,0,0,47,0,0,47
EST,202133,40 – 50,0,0,33,0,0,33
EST,202133,5 – 10,0,0,4,0,0,4
EST,202133,50 – 60,0,0,22,0,0,22
EST,202133,60 – 70,0,0,6,0,0,6
EST,202133,70 – 80,0,0,4,0,0,4
EST,202133,< 1,0,0,3,0,0,3
EST,202133,>= 80,0,0,7,0,0,7
EST,202134,1 – 5,0,0,7,0,0,7
EST,202134,10 – 20,0,0,32,0,0,32
EST,202134,20 – 30,0,0,19,0,0,19
EST,202134,30 – 40,0,0,44,0,0,44
EST,202134,40 – 50,0,0,18,0,0,18
EST,202134,5 – 10,0,0,3,0,0,3
EST,202134,50 – 60,0,0,27,0,0,27
EST,202134,60 – 70,0,0,12,0,0,12
EST,202134,70 – 80,0,0,10,0,0,10
EST,202134,< 1,0,0,1,0,0,1
EST,202134,>= 80,0,0,7,0,0,7
EST,202135,1 – 5,0,0,7,0,0,7
EST,202135,10 – 20,0,0,40,0,0,40
EST,202135,20 – 30,0,0,27,0,0,27
EST,202135,30 – 40,0,0,31,0,0,31
EST,202135,40 – 50,0,0,24,0,0,24
EST,202135,5 – 10,0,0,7,0,0,7
EST,202135,50 – 60,0,0,16,0,0,16
EST,202135,60 – 70,0,0,22,0,0,22
EST,202135,70 – 80,0,0,4,0,0,4
EST,202135,>= 80,0,0,5,0,0,5
EST,202136,1 – 5,0,0,2,0,0,2
EST,202136,10 – 20,0,0,34,0,0,34
EST,202136,20 – 30,0,0,27,0,0,27
EST,202136,30 – 40,0,0,41,0,0,41
EST,202136,40 – 50,0,0,22,0,0,22
EST,202136,5 – 10,0,0,13,0,0,13
EST,202136,50 – 60,0,0,17,0,0,17
EST,202136,60 – 70,0,0,9,0,0,9
EST,202136,70 – 80,0,0,2,0,0,2
EST,202136,>= 80,0,0,4,0,0,4
EST,202137,1 – 5,0,0,2,0,0,2
EST,202137,10 – 20,0,0,44,0,0,44
EST,202137,20 – 30,0,0,18,0,0,18
EST,202137,30 – 40,0,0,33,0,0,33
EST,202137,40 – 50,0,0,28,0,0,28
EST,202137,5 – 10,0,0,7,0,0,7
EST,202137,50 – 60,0,0,22,0,0,22
EST,202137,60 – 70,0,0,8,0,0,8
EST,202137,70 – 80,0,0,2,0,0,2
EST,202137,< 1,0,0,1,0,0,1
EST,202137,>= 80,0,0,6,0,0,6
EST,202138,1 – 5,0,0,4,0,0,4
EST,202138,10 – 20,0,0,30,0,0,30
EST,202138,20 – 30,0,0,14,0,0,14
EST,202138,30 – 40,0,0,29,0,0,29
EST,202138,40 – 50,0,0,40,0,0,40
EST,202138,5 – 10,0,0,11,0,0,11
EST,202138,50 – 60,0,0,27,0,0,27
EST,202138,60 – 70,0,0,11,0,0,11
EST,202138,70 – 80,0,0,5,0,0,5
EST,202138,>= 80,0,0,5,0,0,5
EST,202139,1 – 5,0,0,2,0,0,2
EST,202139,10 – 20,0,0,31,0,0,31
EST,202139,20 – 30,0,0,16,0,0,16
EST,202139,30 – 40,0,0,39,0,0,39
EST,202139,40 – 50,0,0,34,0,0,34
EST,202139,5 – 10,0,0,10,0,0,10
EST,202139,50 – 60,0,0,17,0,0,17
EST,202139,60 – 70,0,0,10,0,0,10
EST,202139,70 – 80,0,0,5,0,0,5
EST,202139,>= 80,0,0,3,0,0,3
EST,202140,1 – 5,0,0,4,0,0,4
EST,202140,10 – 20,0,0,29,0,0,29
EST,202140,20 – 30,0,0,15,0,0,15
EST,202140,30 – 40,0,0,41,0,0,41
EST,202140,40 – 50,0,0,29,0,0,29
EST,202140,5 – 10,0,0,16,0,0,16
EST,202140,50 – 60,0,0,25,0,0,25
EST,202140,60 – 70,0,0,12,0,0,12
EST,202140,70 – 80,0,0,1,0,0,1
EST,202140,>= 80,0,0,1,0,0,1
EST,202141,1 – 5,0,0,1,0,0,1
EST,202141,10 – 20,0,0,23,0,0,23
EST,202141,20 – 30,0,0,10,0,0,10
EST,202141,30 – 40,0,0,35,0,0,35
EST,202141,40 – 50,0,0,29,0,0,29
EST,202141,5 – 10,0,0,7,0,0,7
EST,202141,50 – 60,0,0,23,0,0,23
EST,202141,60 – 70,0,0,22,0,0,22
EST,202141,70 – 80,0,0,8,0,0,8
EST,202141,< 1,0,0,2,0,0,2
EST,202141,>= 80,0,0,4,0,0,4
EST,202142,1 – 5,0,0,2,0,0,2
EST,202142,10 – 20,0,0,23,0,0,23
EST,202142,20 – 30,0,0,20,0,0,20
EST,202142,30 – 40,0,0,41,0,0,41
EST,202142,40 – 50,0,0,28,0,0,28
EST,202142,5 – 10,0,0,10,0,0,10
EST,202142,50 – 60,0,0,15,0,0,15
EST,202142,60 – 70,0,0,13,0,0,13
EST,202142,70 – 80,0,0,8,0,0,8
EST,202142,>= 80,0,0,4,0,0,4
EST,202143,1 – 5,0,0,2,0,0,2
EST,202143,10 – 20,0,0,12,0,0,12
EST,202143,20 – 30,0,0,11,0,0,11
EST,202143,30 – 40,0,0,47,0,0,47
EST,202143,40 – 50,0,0,33,0,0,33
EST,202143,5 – 10,0,0,10,0,0,10
EST,202143,50 – 60,0,0,29,0,0,29
EST,202143,60 – 70,0,0,12,0,0,12
EST,202143,70 – 80,0,0,5,0,0,5
EST,202143,>= 80,0,0,4,0,0,4
EST,202144,1 – 5,0,0,1,0,0,1
EST,202144,10 – 20,0,0,21,0,0,21
EST,202144,20 – 30,0,0,18,0,0,18
EST,202144,30 – 40,0,0,32,0,0,32
EST,202144,40 – 50,0,0,31,0,0,31
EST,202144,5 – 10,0,0,13,0,0,13
EST,202144,50 – 60,0,0,22,0,0,22
EST,202144,60 – 70,0,0,18,0,0,18
EST,202144,70 – 80,0,0,7,0,0,7
EST,202144,>= 80,0,0,5,0,0,5
EST,202145,1 – 5,0,0,2,0,0,2
EST,202145,10 – 20,0,0,18,0,0,18
EST,202145,20 – 30,0,0,17,0,0,17
EST,202145,30 – 40,0,0,19,0,0,19
EST,202145,40 – 50,0,0,18,0,0,18
EST,202145,5 – 10,0,0,10,0,0,10
EST,202145,50 – 60,0,0,15,0,0,15
EST,202145,60 – 70,0,0,22,0,0,22
EST,202145,70 – 80,0,0,6,0,0,6
EST,202145,< 1,0,0,2,0,0,2
EST,202145,>= 80,0,0,3,0,0,3
EST,202146,1 – 5,0,0,7,0,0,7
EST,202146,10 – 20,0,0,36,0,0,36
EST,202146,20 – 30,0,0,18,0,0,18
EST,202146,30 – 40,0,0,38,0,0,38
EST,202146,40 – 50,0,0,25,0,0,25
EST,202146,5 – 10,0,0,9,0,0,9
EST,202146,50 – 60,0,0,20,0,0,20
EST,202146,60 – 70,0,0,12,0,0,12
EST,202146,70 – 80,0,0,8,0,0,8
EST,202146,>= 80,0,0,2,0,0,2
EST,202147,1 – 5,0,0,2,0,0,2
EST,202147,10 – 20,0,0,18,0,0,18
EST,202147,20 – 30,0,0,19,0,0,19
EST,202147,30 – 40,0,0,40,0,0,40
EST,202147,40 – 50,0,0,34,0,0,34
EST,202147,5 – 10,0,0,8,0,0,8
EST,202147,50 – 60,0,0,18,0,0,18
EST,202147,60 – 70,0,0,13,0,0,13
EST,202147,70 – 80,0,0,8,0,0,8
EST,202147,>= 80,0,0,8,0,0,8
EST,202148,1 – 5,0,0,5,0,0,5
EST,202148,10 – 20,0,0,33,0,0,33
EST,202148,20 – 30,0,0,18,0,0,18
EST,202148,30 – 40,0,0,30,0,0,30
EST,202148,40 – 50,0,0,27,0,0,27
EST,202148,5 – 10,0,0,18,0,0,18
EST,202148,50 – 60,0,0,19,0,0,19
EST,202148,60 – 70,0,0,13,0,0,13
EST,202148,70 – 80,0,0,7,0,0,7
EST,202148,< 1,0,0,2,0,0,2
EST,202148,>= 80,0,0,4,0,0,4
EST,202149,1 – 5,0,0,5,0,0,5
EST,202149,10 – 20,0,0,32,0,0,32
EST,202149,20 – 30,0,0,27,0,0,27
EST,202149,30 – 40,0,0,32,0,0,32
EST,202149,40 – 50,0,0,27,0,0,27
EST,202149,5 – 10,0,0,18,0,0,18
EST,202149,50 – 60,0,0,10,0,0,10
EST,202149,60 – 70,0,0,13,0,0,13
EST,202149,70 – 80,0,0,2,0,0,2
EST,202149,>= 80,0,0,8,0,0,8
EST,202150,1 – 5,0,0,3,0,0,3
EST,202150,10 – 20,0,0,27,1,0,28
EST,202150,20 – 30,0,0,23,0,0,23
EST,202150,30 – 40,0,0,34,0,0,34
EST,202150,40 – 50,0,0,21,3,0,24
EST,202150,5 – 10,0,0,13,0,0,13
EST,202150,50 – 60,0,0,19,0,0,19
EST,202150,60 – 70,0,0,14,0,0,14
EST,202150,70 – 80,0,0,8,0,0,8
EST,202150,>= 80,0,0,7,0,0,7
EST,202151,1 – 5,0,0,1,0,0,1
EST,202151,10 – 20,0,0,12,7,0,19
EST,202151,20 – 30,0,0,7,5,0,12
EST,202151,30 – 40,0,0,14,1,1,16
EST,202151,40 – 50,0,0,14,0,0,14
EST,202151,5 – 10,0,0,5,1,0,6
EST,202151,50 – 60,0,0,11,3,0,14
EST,202151,60 – 70,0,0,5,0,0,5
EST,202151,70 – 80,0,0,2,0,0,2
EST,202151,>= 80,0,0,1,0,0,1
